anniversary	n.	周年纪念
anything	pron.	任何事情
April	n.	4月
ask (=invite)	v.	邀请
August	n.	8月
birthday	n.	生日
card	n.	贺卡
celebrate	v.	庆祝
February	n.	2月
Christmas	n.	圣诞节
festival	n.	节日
dance	n.	舞会
get married	 	结婚
December	n.	12月
girlfriend	n.	女朋友
embarrassing	a.	令人尴尬的
graduation	n.	毕业
end	v.	结束
Halloween	n.	万圣节
Fabulous!	 	好极了!
Father's Day	 	父亲节
holiday	n.	假期
Independence Day	 	独立日
next	a.	下次的，接下去的
invite	v.	邀请
next month	 	下个月
January	n.	1月
next summer	 	明年夏天
July	n.	7月
next week	 	下周
June	n.	6月
November	n.	11月
March	n.	3月
occasion	n.	场合
May	n.	5月
October	n.	10月
Mother's Day	 	母亲节
order	v.	点莱
New Year's Day	 	元旦
parade	n.	游行
party	n.	聚会
take someone out	 	带某人出去玩
picture	n.	照片
take pictures	 	照相
present	n.	礼物
Thanksgiving	n.	感恩节
send	v.	送
this weekend	 	这个周末
September	n.	9月
tomorrow night	 	明天晚上
so(=very)	ad.	非常
tonight	ad.	在今晚
special	a.	特殊的，特别的
Valentine's Day	 	情人节
wedding	n.	婚礼
stay (home)	v.	呆在(家中)