bean	n.	豆，豆形果实
All right.	 	好的
beef	n.	牛肉
always	ad.	总是，一直
bread	n.	面包
apple	n.	苹果
broccoli	n.	花椰莱
at (my desk)	prep.	在(我的桌边)
butter	n.	黄油
buy	v.	购买
awful	a.	糟糕的
cake	n.	蛋糕
bacon	n.	熏猪肉
candy	n.	糖果
banana	n.	香蕉
carrot	n.	胡萝卜
celery	n.	芹菜
cream	n.	奶油
cereal	n.	谷类食物
custom	n.	风俗，习惯
cheese	n.	干酪，奶酪
dairy food	 	奶制品
chicken	n.	鸡肉
dessert	n.	甜点
coffee	n.	咖啡
dollar	n.	美元纸币
coin	n.	硬币
drink	n.	饮料
drink	v.	喝，喝酒
collard greens	 	羽衣甘蓝(可食用)
cookie	n.	甜饼干
egg	n.	蛋
cracker	n.	薄脆饼干
fish	n.	鱼，鱼肉
for (breakfast/picnic)	prep.	供(早餐/野餐)用
ice cream	 	冰淇淋
jam	n.	果酱
fruit salad	 	水果色拉
jelly	n.	果冻
grape	n.	葡萄
lemonade	n.	柠檬汽水
habit	n.	习惯
hamburger	n.	汉堡包
lettuce	n.	莴苣
mango	n.	芒果
hardly ever	 	几乎从来不
Hmm.	 	嗯(人们在思考时发出的声音)
mayonnaise	n.	蛋黄酱
mealtime	a.	吃饭期间的
orange	n.	橙，柑
pasta	n.	意大利面食
milk	n.	牛奶
pickle	n.	泡莱
never	ad.	从未
picnic	n.	野餐
noodle	n.	面条
pie	n.	馅饼
nut	n.	坚果
potato	n.	马铃薯
often	ad.	经常
potato chips	 	炸土豆条
oil	n.	油
put	v.	放置
rice	n.	米饭
onion	n.	洋葱
round	a.	圆的
tangerine	n.	柑橘
(potato) salad	n.	(土豆)色拉
(green) tea	n.	(绿)茶
toast	n.	烤面包(片)
snack	n.	小吃，点心
tomato	n.	番茄
soup	n.	汤
tortilla	n.	玉米粉圆饼
strawberry	n.	草莓
try	v.	努力，试图
usually	ad.	通常
strength	n.	力量
(Japanese)-style	a.	(日)式的
want	v.	想要
sweet	a.	甜的，甜蜜的
yogurt	n.	酸奶