bike riding	 	骑自行车
cash	n.	现金
ability	n.	能力
act	v.	表演
chess	n.	国际象棋
artistic	a.	艺术的
course	n.	跑道;赛场
cross	v.	穿越
athletic	a.	运动的
design	v.	设计
bake	v.	烘烤
downriver	a.	顺流的
baseball	n.	棒球
draw	v.	画画
basketball	n.	篮球
enter (a contest)	v.	参加(比赛)
beach	n.	海滩
fix	v.	修理
ice-skating	n.	滑冰
football	n.	(美式)足球
joke	n.	玩笑
free time	 	空闲时间
mechanical	a.	机械的，呆板的
golf	n.	高尔夫球
gymnastics	n.	体操
musical	a.	音乐的
not at all	 	一点儿也不
hidden	a.	隐藏的
hiking	n.	徒步旅行
once/twice a month	 	一个月一次/两次
hockey	n.	曲棍球
paint	v.	(用颜料等)画
so	ad.	那么(用于开始一个话题)
piano	n.	钢琴
practice	v.	实践，实行
sport	n.	运动
step	n.	台阶
prize	n.	奖品
surf	v.	冲浪
reach the top	 	到达顶点
Take the challenge!	 	接受挑战!
really well	 	非常顺利
talent	n.	才能
ride	v.	骑
talent show	 	新秀发掘演出
sing	v.	唱歌
team	n.	团体
skiing	n.	滑雪
technical	a.	技术的
tell jokes	 	讲笑话
time-out	n.	暂停
tomorrow	ad.	在明天
violin	n.	小提琴
volleyball	n.	排球
Web page	 	网页
white waters	 	白浪