another	a.	另一
any	a.	任何的
apartment building	 	公寓楼
appliance	n.	家用电器
armchair	n.	扶手椅
bathroom	n.	浴室
bed	n.	床
bedroom	n.	卧室
dresser	n.	梳妆合
big	a.	大的
bookcase	n.	书架，书柜
elevator	n.	电梯
cabin	n.	小木屋
expensive	a.	昂贵的
closet	n.	储藏室
(first/second) floor	n.	(第一/第二) 层
curtain	n.	窗帘
difference	n.	差异，不同
forest	n.	森林
furniture	n.	家具
dining room	 	餐厅
garage	n.	车库
dream (home)	n.	理想 (家园)
Guess what!	 	我有个有趣的消息!
guest	n.	客人
love	v.	喜爱
hall	n.	大厅
microwave oven	 	微波炉
houseboat	n.	船屋
mirror	n.	镜子
just (one room)	ad.	仅有(一个房间)
Native American	 	美洲土著
next (weekend)	ad.	下 (周末)
kitchen	n.	厨房
lamp	n.	灯
no	a.	没有的，全无的
laundry room	 	洗衣房
penthouse	n.	(昂贵舒适的)楼顶公寓
living room	 	起居室
lobby	n.	休息室
picture	n.	图片
porch	n.	门廊
traditional	a.	传统的
refrigerator	n.	冰箱
tribe	n.	部落
room	n.	房间
view	n.	景色，风景
rug	n.	地毯
villa	n.	别墅
sofa	n.	沙发
some	a.	一些，若干
visitor	n.	来访者
stair	n.	楼梯
wood-burning stove	 	烧木头的炉子
store	n.	商店
stove	n.	炉子
yard	n.	院子
think	v.	认为