busy	a.	忙碌的
a lot of	 	很多
by (bus/car)	prep.	乘(公共汽车/汽车)
all day	 	整日
all night	 	整夜
car	n.	汽车
alone	ad.	独自地
child (=kid)	n.	孩子
apartment	n.	公寓
coffee shop	 	咖啡店
break	n.	间歇
computer	n.	计算机
brother	n.	兄弟
bus	n.	公共汽车
daughter	n.	女儿
far (from here)	ad.	(距这里)遥远地
downtown	ad.	在城镇商业中心区
Friday	n.	星期五
early	ad.	早，在初期
get to(=go to)	 	去……
early bird	 	习惯早起的人
end	v.	结束
go for a run (=run)	 	去跑步
every	a.	每个，每一
homework	n.	家庭作业
every day	 	每天
exercise	v.	锻炼，运动
house	n.	房子
husband	n.	丈夫
job	n.	工作
need	v.	需要
late	ad.	晚，迟
night owl	 	习惯熬夜的人
live	v.	生活
office	n.	办公室
me	pron.	我(宾格)
on (Sundays)	prep.	在(星期天)
meet	v.	遇到
Monday	n.	星期一
park	n.	公园
motorcycle	n.	摩托车
project	n.	任务，项目
public	a.	公共的
near (our house)	prep.	在(我们家)附近
public transportation	 	公共交通工具
restaurant	n.	饭店
slow	a.	缓慢的
retired	a.	退休的
sometimes	ad.	有时
routine	n.	日常安排
son	n.	儿子
Saturday	n.	星期六
start	v.	开始
school	n.	学校
stop	v.	停止
see (family/friends)	v.	看望(家人/朋友)
suburb	n.	郊区
subway	n.	地铁
serve	v.	供应(饭莱等)
Sunday	n.	星期日
sister	n.	姐，妹
Sure.	 	当然可以。
survey	n.	调查
train	n.	火车
take (a taxi/cab)	v.	乘坐(出租车)
transportation	n.	交通
taxi (=cab)	n.	出租车
Tuesday	n.	星期二
then	ad.	那么
us	pron.	我们(宾格)
use	v.	使用
Thursday	n.	星期四
together	ad.	在一起，共同
Wednesday	n.	星期三
weekday	n.	工作日
top	a.	最受欢迎的
weekend	n.	周末
weekly	ad.	每周地
when	ad.	什么时候
wife	n.	妻子
with (my parents)	prep.	和 (我的父母)一起
Yeah.	 	是的