believe it or not	 	信不信由你
already	ad.	已经
better	a.	好转的
ankle	n.	脚踝
calcium	n.	钙
antacid	n.	抗酸剂
chest	n.	胸部
arm	n.	手臂
chin	n.	下颌
aspirin	n.	阿司匹林
cold	n.	感冒
awful	a.	难受的
common	a.	常见的，普通的
back	n.	背
backache	n.	腰背酸痛
cold pills	 	感冒药片
cough	n.	咳嗽
eye drops	 	眼药水
cough drop	 	止咳糖，止咳片
fever	n.	发烧
cough syrup	 	止咳糖浆
fine(=well)	a.	(情况)好的
ear	n.	耳朵
finger	n.	手指
earache	n.	耳痛
(the) flu	n.	流感
elbow	n.	肘部
foot	n.	脚
exhausted	a.	筋疲力尽的
give	v.	给
great	a.	非常好的
eye	n.	眼睛
hand	n.	手
head	n.	头
medication	n.	药物
headache	n.	头痛
heel	n.	脚后跟
mouth	n.	嘴
homesick	a.	想家的
muscle cream	 	肌肉松弛软膏
hurt	v.	刺痛，伤害
neck	n.	颈部
improve	v.	改善
nose	n.	鼻子
knee	n.	膝盖
patient	n.	病人
leg	n.	腿
point	v.	指出
Let's take a look at you.	 	让我给你检查一下。
(cold) pill	n.	(感冒)药片
rest	v.	休息
stomach	n.	胃
shoulder	n.	肩膀
stomachache	n.	胃痛
sick	a.	生病的
soon	ad.	早，快
take a pill	 	吃一片药
simple	a.	简单的
terrible	a.	糟糕的
soda	n.	汽水
terrific	a.	非常好的
sore (eyes/throat)	a.	(眼睛/喉咙) 疼的
That's too bad.	 	太糟糕了(表示同情)。
stay up	 	熬夜
throat	n.	喉咙
thumb	n.	拇指
tired	n.	疲倦的
toe	n.	脚趾
tooth	n.	牙齿
toothache	n.	牙痛
wrist	n.	手腕
wrong	a.	错误的