a little	 	一点
baby	n.	(一群人中)年纪最轻的一个
beautiful	a.	美丽的
best friend	 	最好的朋友
brother	n.	兄弟
city	n.	城市
cute	a.	可爱的
early	a.	早的
handsome	a.	英俊的
false	a.	错误的
heavy	a.	沉的，重的
family	n.	家庭
in (Mexico)	prep.	在 (墨西哥)
friendly	a.	友好的
from (Seoul)	prep.	来自(首尔)
language	n.	语言
large	a.	大的
funny	a.	滑稽的
mother	n.	母亲
good-looking	a.	好看的，漂亮的
nationality	n.	民族;国籍
new	a.	新的
pretty	a.	漂亮的
nice	a.	善良的，好的
really	ad.	确实地，实在
of (the family)	prep.	在 (一家人)中
serious	a.	严肃的
short	a.	短的
old	a.	旧的
shy	a.	害羞的
originally	ad.	原来，最初
sister	n.	姐妹
smart	a.	聪明的
parent	n.	父亲，母亲
so	ad.	非常，如此
partner	n.	伙伴
student	n.	学生
talkative	a.	健谈的
tall	a.	高的
thin	a.	瘦的
this week	 	这周
true	a.	正确的
we	pron.	我们
world	n.	世界