amusement park	 	游乐园
answering machine	 	电话留言机
around (7 o'clock)	prep.	大约(7点)
art	n.	艺术品
at (the beach)	prep.	在 (海滩)
babysit	v.	代人临时照看小孩儿
call (you) back	 	给(你)回电话
have to	 	不得不
comedy	n.	喜剧
help	v.	帮助
concert	n.	音乐会
in (bed/class/Mexico)	prep.	在(床上/上课/墨西哥)
dance club	 	舞厅
date	n.	日期
in the (hospital/shower/yard)	 	在(医院/洗澡/院子里)
excuse	n.	借口
exotic	a.	异国情调的
invitation	n.	邀请
experience	v.	经历，体验
jewelry	n.	首饰
latest	a.	最新的
popular	a.	受人欢迎的
leave a message	 	留言
sell out	 	卖光
message	n.	信息，口信 
shower	n.	淋浴
tone	n.	提示音
multicultural	a.	多文化的
trick	n.	绝技
trip	n.	旅行
nature park	 	野生植物园
under the stars	 	在星空下
need to	 	需要
want to	 	想要
What's up?	 	有什么事吗?
on (one's break/vacation)	prep.	在 (休息/休假)
would like to	 	愿意