across from	 	在……对面
attraction	n.	吸引人的事物
avenue	n.	大街
bank	n.	银行
be modeled after	 	照……仿效
behind	prep.	在……后面
between	prep.	在……之间
drugstore	n.	杂货店
entrance	n.	入口
block	n.	街区
gas station	 	加油站
bookstore	n.	书店
gasoline	n.	汽油
bridge	n.	桥
Go down/up.	 	向南/北走。
cathedral	n.	大教堂
library	n.	图书馆
center	n.	中心
ma'am	n.	女士
coffee shop	 	咖啡店
map	n.	地图
department store	 	百货商店
movie theater	 	电影院
neighborhood	n.	附近，临近
post office	 	邮局
public rest room	 	公共洗手间
next to	 	紧靠……旁边
rink	n.	溜冰场
on (Main Street)	prep.	在(主街)上
shoe store	 	鞋店
square	n.	广场
on the corner of	 	在……拐角处
street	n.	街道
on the left/right	 	在左/右边
supermarket	n.	超市
other	a.	其他的
parking lot	 	停车场
tourist	n.	游客
traveler's check	 	旅行支票
turn around	 	转身
Turn left/right.	 	向左/右转。
Walk down/up.	 	向南/北走。
You can't miss it.	 	很容易找到的。