almost	ad.	几乎
anywhere	ad.	任何地方
break down	 	(车)抛锚
campsite	n.	(野)营地
ceremony	n.	典礼，仪式
clean	v.	清扫
last night	 	昨天晚上
come home	 	回家
last summer	 	去年夏天
different	a.	不同的
last week	 	上周
go camping	 	去野营
last weekend	 	上周末
go out	 	出去玩
last year	 	去年
have fun	 	娱乐
lesson	n.	课，课程
in line	 	成排，成列
mail	n.	邮件
invite …… over	 	邀请……来
mall	n.	购物街
last month	 	上个月
meeting	n.	会议
music	n.	音乐
vacation	n.	假期
put up	 	支起，立起
visit	v.	拜访
roommate	n.	室友
white-water rafting	 	漂流
stay home	 	呆在家里
yesterday	ad.	在昨天
stay out	 	呆在户外
take classes/lessons	 	选课
tent	n.	帐篷
test	n.	考试
travel	v.	旅行